PXXXXXXXXXXXXXXXXXXXXXXXXXXXXXXXXXXXXXXXXXXXXXXXXXXXXXXXXXXX
PXXXXOOOOOOOFSOOOOOOOOOOOOOOOOOOOOOO1OOOOOOOOOOOOOOOXXXXXXXX
PXXOOOOOOOOOFSOOOOOOOOOOOOOOOOOOOOO1O1OOOOOOOOOOOOOOOOOXXXXX
PXOOOOOOOOOOFSOOOOOOOOOOOOOOOOOOOO1O1O1OOOOOOOOOOOOOOOOOOXXX
PXOOOOOOOOOOFSOOOOOOOOOOOOOOOOOOO1O1O1O1OOOOOOOOOOOOOOOOOOOX
XOOOOOOOOOOOFSOOOOOOOOOOOOOOOOOO1O1O1O1O1OOOOOOOOOOOOOOOOOOX
XXOOOOOOOOXXXXXXXXXXXXXXXXXXXXXXXXXXXXXXXXXXXXXXXOOOOOOOOOOX
XOOOOOOOXXXXXXXXXXXXXXXXXXXXXXXXXXOOOOOOOOOOXXXXXXXOOOOOOOOX
XOOOOOOXXXXXXXXXXXXXXXXXXXXXXXXXOOOOOOOOOOOOOXXXXXXOOOOOOOXX
X77777XXXXXXXXXXXXXXXXXXXXXXXXXOOOOOOOOOOOOOOOOXXXOOOOOOOOXX
XOOOOOXXXXXXXXXXXXXXXXXXXXXXXOOOOOOOOXXOOOOOOO33XXX2O2O2O2XX
XOOOOOOXXXXXXXXXXXXXXXXXXXXXOOOOOOOOOXXXXXOO3333OXX2222222XX
XOOOOOOOOXXXXXXXXXXXXXXXXXXXXOOOOOOOXXXXXXXX333OOOOOOOOOOXXX
XOOOOOOOOXXXXXXXXXXXXXXXXXXXXX444444XXXXXXXXXOOOOOOOOOOOOXXX
XXOOOOOOOOOXXXXXXXXXXXXXXXXXXXXOOOOOOXXXXXXXXOOOOOOOOOOOXXXX
XXXOOOOOOO666XXXXXXXXXXXXXXXXXXXOOOOOOOXXXXXXXXOOOOOOOOXXXXX
XXXOOOOOO66OOOOOOOOOOXXXXXXXXXXXXOOOOOOOXXXXXXXXXXXXXXXXXXXX
XXXOOOOOO6OOOOOOOOOOOOOOXXXXXXXXOOOOOOOOXXXXXXXXXXXXXXXXXXXX
XXXXXXXXX6OOOOOOOOOOOOOOOOXXXOOOOOOOOOOOXXXXXXXXXXXXXXXXXXXX
XXXXXXXXXXXXXXXXOOOOOOOOOO555OOOOOOOOOOXXXXXXXXXXXXXXXXXXXXX
XXXXXXXXXXXXXXXXXXXOOOOOOO555OOOOOOOOXXXXXXXXXXXXXXXXXXXXXXX
XXXXXXXXXXXXXXXXXXXXXOOOOO555OOOOOOXXXXXXXXXXXXXXXXXXXXXXXXX
XXXXXXXXXXXXXXXXXXXXXXXXXO555OOOXXXXXXXXXXXXXXXXXXXXXXXXXXXX
XXXXXXXXXXXXXXXXXXXXXXXXXXXXXXXXXXXXXXXXXXXXXXXXXXXXXXXXXXXX
XXXXXXXXXXXXXXXXXXXXXXXXXXXXXXXXXXXXXXXXXXXXXXXXXXXXXXXXXXXX
