PPPPPPPPPPPPPPPPPPPPPPPPPPPPPPPPPPPPPPPPPPPPPPPPPPPPPPPPPPPPPPPPPPPPPPPP
POOOOSOSPPOOOOOOOPPOOOOOOOPPOOOOOOOPPOOOOOOOPPOOOOOOOPPOOOOOOOPPOOOOOOOP
POOOSOSOPPOOOOOOOPPOOOOOOOPPOOOOOOOPPOOOOOOOPPOOOOOOOPPOOOOOOOPPOOOOOOOP
POOSOSOOOOOOOOOOOOOOOOOOOOXXOOOOOOOOOOOOOOOOOOOOOOOOOXXOOOOOOOOOOO222OOP
POSOSOOOOOOOOOOOOOOOOOOOOOXXOOOOOOOOOOOOOOOOOOOOOOOOOXXOOOOOOOOOOO222OOP
PSOSOOOOOOOOOOOOOOOOOOOOOOXXOOOOOOOOOOOOOOOOOOOOOOOOOXXOOOOOOOOOOO222OOP
POSOOOOOPPOOOOOOOPPOOOOOOOPPOOOOOOOPPOOOOOOOPPOOOOOOOPPOOOOOOOPPOOOOOOOP
PSOOOOOOPPOOOOOOOPPOOOOOOOPPOOOOOOOPPOOOOOOOPPOOOOOOOPPOOOOOOOPPOOOOOOOP
PPPOOOPPPPPPXXXPPPPPPXXXPPPPPPXXXPPPPPPOOOPPPPPPOOOPPPPPPOOOPPPPPPOOOPPP
PPPOOOPPPPPPXXXPPPPPPXXXPPPPPPXXXPPPPPPOOOPPPPPPOOOPPPPPPOOOPPPPPPOOOPPP
POOOOOOOPPOOOOOOOPPOOOOOOOPPOOOOOOOPPOOOOOOOPPOOOOOOOPPOOOOOOOPPOOOOOOOP
POOOOOOOPPOOOOOOOPPOOOOOOOPPOOOOOOOPPOOOOOOOPPOOOOOOOPPOOOOOOOPPOOOOOOOP
POOOOOOOOOOOOOOOOXXOOOOOOOOOOOOOOOOOOOOOOOOOOOOOOOOOOXXOOOOOOOXXOOOOOOOP
POOOOOOOOOOOOOOOOXXOOOOOOOOOOOOOOOOOOOOOOOOOOOOOOOOOOXXOOOOOOOXXOOOOOOOP
POOOOOOOOOOOOOOOOXXOOOOOOOOOOOOOOOOOOOOOOOOOOOOOOOOOOXXOOOOOOOXXOOOOOOOP
POOOOOOOPPOOOOOOOPPOOOOOOOPPOOOOOOOPPOOOOOOOPPOOOOOOOPPOOOOOOOPPOOOOOOOP
POOOOOOOPPOOOOOOOPPOOOOOOOPPOOOOOOOPPOOOOOOOPPOOOOOOOPPOOOOOOOPPOOOOOOOP
PPPOOOPPPPPPOOOPPPPPPXXXPPPPPPOOOPPPPPPOOOPPPPPPOOOPPPPPPOOOPPPPPPOOOPPP
PPPOOOPPPPPPOOOPPPPPPXXXPPPPPPOOOPPPPPPOOOPPPPPPOOOPPPPPPOOOPPPPPPOOOPPP
POOOOOOOPPOOOOOOOPPOOOOOOOPPOOOOOOOPPOOOOOOOPPOOOOOOOPPOOOOOOOPPOOOOOOOP
POOOOOOOPPOOOOOOOPPOOOOOOOPPOOOOOOOPPOOOOOOOPPOOOOOOOPPOOOOOOOPPOOOOOOOP
POOOOOOOXXOOOOOOOXXOOOOOOOOOOOOOOOOXXOO444OOXXOOOOOOOOOOOOOOOOXXOOOOOOOP
POOOOOOOXXOOOOOOOXXOOOOOOOOOOOOOOOOXXOO444OOXXOOOOOOOOOOOOOOOOXXOOOOOOOP
POOOOOOOXXOOOOOOOXXOOOOOOOOOOOOOOOOXXOO444OOXXOOOOOOOOOOOOOOOOXXOOOOOOOP
POOOOOOOPPOOOOOOOPPOOOOOOOPPOOOOOOOPPOOOOOOOPPOOOOOOOPPOOOOOOOPPOOOOOOOP
POOOOOOOPPOOOOOOOPPOOOOOOOPPOOOOOOOPPOOOOOOOPPOOOOOOOPPOOOOOOOPPOOOOOOOP
PPPOOOPPPPPPXXXPPPPPPOOOPPPPPPXXXPPPPPPXXXPPPPPPXXXPPPPPPOOOPPPPPPOOOPPP
PPPOOOPPPPPPXXXPPPPPPOOOPPPPPPPPPPPPPPPPPPPPPPPPXXXPPPPPPOOOPPPPPPOOOPPP
POOOOOOOPPOOOOOOOPPOOOOOOOPPPPPPPPPPPPPPPPPPPPOOOOOOOPPOOOOOOOPPOOOOOOOP
POOOOOOOPPOOOOOOOPPOOOOOOOPPPXXXFXXXXXXFXXXPPPOOOOOOOPPOOOOOOOPPOOOOOOOP
POOOOOOOOOOOOOOOOOOOOOOOOOXPPXXFXXXXXXXXFXXPPXOOOOOOOOOOOOOOOOOOOOOOOOOP
POOOOOOOOOOOOOOOOOOOOOOOOOXPPXFXXXXXXXXXXFXPPXOOOOOOOOOOOOOOOOOOOOOOOOOP
POOOOOOOOOOOOOOOOOOOOOOOOOXPPXFXXXXXXXXXXFXPPXOOOOOOOOOOOOOOOOOOOOOOOOOP
POOOOOOOPPOOOOOOOPPOOOOOOOPPPXFFFPPPPPPFFFXPPPOOOOOOOPPOOOOOOOPPOOOOOOOP
POOOOOOOPPOOOOOOOPPOOOOOOOPPPXXFPPPPPPPPFXXPPPOOOOOOOPPOOOOOOOPPOOOOOOOP
PPPOOOPPPPPPXXXPPPPPPOOOPPPPPXXXPPPPPPPPXXXPPPPPOOOPPPPPPXXXPPPPPPOOOPPP
PPPOOOPPPPPPXXXPPPPPPOOOPPPPPXPPPPPPPPPPPPXPPPPPOOOPPPPPPXXXPPPPPPOOOPPP
POOOOOOOPPOOOOOOOPPOOOOOOOPPPXXXPXPPPPXPXXXPPPOOOOOOOPPOOOOOOOPPOOOOOOOP
POOOOOOOPPOOOOOOOPPOOOOOOOPPPXXXPPPPPPPPXXXPPPOOOOOOOPPOOOOOOOPPOOOOOOOP
POOOOOOOXXOOOOOOOOOOOOOOOOXPPXXXPPPPPPPPXXXPPXOOOOOOOXXOOOOOOOOOOO333OOP
POOOOOOOXXOOOOOOOOOOOOOOOOXPPXXXXPPPPPPXXXXPPXOOOOOOOXXOOOOOOOOOOO333OOP
POOOOOOOXXOOOOOOOOOOOOOOOOXPPXXXXXPFFPXXXXXPPXOOOOOOOXXOOOOOOOOOOO333OOP
POOOOOOOPPOOOOOOOPPOOOOOOOPPPXXXXXXXXXXXXXXPPPOOOOOOOPPOOOOOOOPPOOOOOOOP
POOOOOOOPPOOOOOOOPPOOOOOOOPPPPPPPPPPPPPPPPPPPPOOOOOOOPPOOOOOOOPPOOOOOOOP
PPPOOOPPPPPPXXXPPPPPPXXXPPPPPPPPPPPPPPPPPPPPPPPPOOOPPPPPPOOOPPPPPPXXXPPP
PPPOOOPPPPPPXXXPPPPPPXXXPPPPPPXXXPPPPPPXXXPPPPPPOOOPPPPPPOOOPPPPPPXXXPPP
POOOOOOOPPOOOOOOOPPOOOOOOOPPOOOOOOOPPOOOOOOOPPOOOOOOOPPOOOOOOOPPOOOOOOOP
POOOOOOOPPOOOOOOOPPOOOOOOOPPOOOOOOOPPOOOOOOOPPOOOOOOOPPOOOOOOOPPOOOOOOOP
POOOOOOOOOOOOOOOOOOOOOOOOOXXOOOOOOOOOOOOOOOOOOOOOOOOOXXOOOOOOOXXOO555OOP
POOOOOOOOOOOOOOOOOOOOOOOOOXXOOOOOOOOOOOOOOOOOOOOOOOOOXXOOOOOOOXXOO555OOP
POOOOOOOOOOOOOOOOOOOOOOOOOXXOOOOOOOOOOOOOOOOOOOOOOOOOXXOOOOOOOXXOO555OOP
POOOOOOOPPOOOOOOOPPOOOOOOOPPOOOOOOOPPOOOOOOOPPOOOOOOOPPOOOOOOOPPOOOOOOOP
POOOOOOOPPOOOOOOOPPOOOOOOOPPOOOOOOOPPOOOOOOOPPOOOOOOOPPOOOOOOOPPOOOOOOOP
PPPXXXPPPPPPXXXPPPPPPOOOPPPPPPXXXPPPPPPOOOPPPPPPOOOPPPPPPOOOPPPPPPOOOPPP
PPPXXXPPPPPPXXXPPPPPPOOOPPPPPPXXXPPPPPPOOOPPPPPPOOOPPPPPPOOOPPPPPPOOOPPP
POOOOOOOPPOOOOOOOPPOOOOOOOPPOOOOOOOPPOOOOOOOPPOOOOOOOPPOOOOOOOPPOOOOOOOP
POOOOOOOPPOOOOOOOPPOOOOOOOPPOOOOOOOPPOOOOOOOPPOOOOOOOPPOOOOOOOPPOOOOOOOP
POOOOOOOOOOOOOOOOOOOOOOOOOXXOOOOOOOOOOOOOOOOXXOOOOOOOOOOOOOOOOXXOOOOOOOP
POOOOOOOOOOOOOOOOOOOOOOOOOXXOOOOOOOOOOOOOOOOXXOOOOOOOOOOOOOOOOXXOOOOOOOP
POOOOOOOOOOOOOOOOOOOOOOOOOXXOOOOOOOOOOOOOOOOXXOOOOOOOOOOOOOOOOXXOOOOOOOP
POOOOOOOPPOOOOOOOPPOOOOOOOPPOOOOOOOPPOOOOOOOPPOOOOOOOPPOOOOOOOPPOOOOOOOP
POOOOOOOPPOOOOOOOPPOOOOOOOPPOOOOOOOPPOOOOOOOPPOOOOOOOPPOOOOOOOPPOOOOOOOP
PPPOOOPPPPPPXXXPPPPPPOOOPPPPPPOOOPPPPPPXXXPPPPPPOOOPPPPPPXXXPPPPPPOOOPPP
PPPOOOPPPPPPXXXPPPPPPOOOPPPPPPOOOPPPPPPXXXPPPPPPOOOPPPPPPXXXPPPPPPOOOPPP
POOOOOOOPPOOOOOOOPPOOOOOOOPPOOOOOOOPPOOOOOOOPPOOOOOOOPPOOOOOOOPPOOOOOOOP
POOOOOOOPPOOOOOOOPPOOOOOOOPPOOOOOOOPPOOOOOOOPPOOOOOOOPPOOOOOOOPPOOOOOOOP
POO111OOOOOOOOOOOOOOOOOOOOOOOOOOOOOOOOOOOOOOOOOOOOOOOOOOOOOOOOOOOOFFFOOP
POO111OOOOOOOOOOOOOOOOOOOOOOOOOOOOOOOOOOOOOOOOOOOOOOOOOOOOOOOOOOOOFFFOOP
POO111OOOOOOOOOOOOOOOOOOOOOOOOOOOOOOOOOOOOOOOOOOOOOOOOOOOOOOOOOOOOFFFOOP
POOOOOOOPPOOOOOOOPPOOOOOOOPPOOOOOOOPPOOOOOOOPPOOOOOOOPPOOOOOOOPPOOOOOOOP
POOOOOOOPPOOOOOOOPPOOOOOOOPPOOOOOOOPPOOOOOOOPPOOOOOOOPPOOOOOOOPPOOOOOOOP
PPPPPPPPPPPPPPPPPPPPPPPPPPPPPPPPPPPPPPPPPPPPPPPPPPPPPPPPPPPPPPPPPPPPPPPP
