PXXXXXXXXXXXXXXXXXXXXXXXXXXXXX
PXXXXXXXXZZZZZXXXZZZZZZZZXXXXX
PXXXXXXXZYYYYZXXYYYYYYYYZZXXXX
XXXXXXZZYOOOYZXYOOO2OOOOYZZXXX
XXXXXZYYOOOOYYYOOOO2OOOOOYZZXX
XXXZZYYOOOOOYOOOOOO2OOOOOOYZZX
XXZYYYOOOOOOYOOOOOO2OOOOOOOYZZ
XXYYSOOOOOOO7OOOOYYYYYYOOOOOYZ
XYOOSOOOOOOO7OOOYXXXXXXYOOOOYZ
XYOOSOOOOOOO7OOOYXXXXXXXYOOOYZ
XYOOOOYYOOOOYYYYXXXXXXXXYOOOYZ
XYOOYYXYOOOOYZXXXXXXXXXYOOOOYZ
XYYYXXXYOOOOYZXXXXXXXXXYOOOYZZ
XXXXXXXYOOOOYZXXXXXXXXYOOOOYZX
XXXXXXXYOOOOYZXXXXXXXYOOOOYZZX
XXXXXXXYOOOOYZXXXXXXYOOOOOYZXX
XXXXXXXY1111YZXXXXXYOOOOOYZZXX
XXXXXXXYOOOOYZXXXXY3OOOOYZZXXX
XXXXXXXYOOOOYZXXXYOO3OOYZZXXXX
XXXXXXXYOOOOYZXXYOOOO3YZZXXXXX
XXXXXXXYOOOOYZYYOOOOYYZZXXXXXX
XXXXXXXYOOOOYYOOOOOYYZZZZZZZZZ
XXXXXXXYOOOOYOOOOOYYYYYYYYYYYZ
XXXXXXXYOOOO5OOOOOOOOOOOOOOFYZ
XXXXXXXYOOOO5OOOOOOOOOOOOOOFYZ
XXXXXXXYOOOO5OOOOOOOOOOOOOOFYZ
XXXXXXXYOOOO5OOOOOOOOOOOOOOFYZ
XXXXXXXYYYYYYYYYYYYYYYYYYYYYYX
XXXXXXXXXXXXXXXXXXXXXXXXXXXXXX
