PXXXXXXXXXXXXXXXXXXXXXXXXXXXXXXXXXXXXXXXXXXXXXXXXXXXXXXXXXXXXXXXXXXXXXXXXXXXXXXXXXXXXXXXXXXXXXXXXXXXXXXXXXXXXXXXXXXXXXX
PXXXXXXXXXXXXXXXXXXXXXXXXXXXXXXXXXXXXXXXXXXXXXXXXXXXXXXXXXXXXXXXXXXXXXXXXXXXXXXXXXXXXXXXXXXXXXXXXXXXXXXXXXXXXXXXXXXXXXX
PXXXXXXXXXXXXXXXXXXXXXXXXXXXXXXOOOOOOOOOOOOOOOOOOOOOOOOOOXXXXXXXXXXXXXXOOOXOOOOOOOXOOOOOOOOOOOOOOOOOOOOOOOOOOOOOOOXXXXX
PXXXXXXXXXXXXXXXXXXXXXXXXXXXXOOOOXOXOOOOOOOOOOOOOOOOOOOOOOXXXXXXXXXXXOOOOOOOXOOOXOOOXOOOOOOOOOOOOOOOOOOOOOOOOOOOOOOXXXX
PXXXXXXXXXXXXXXXXXXXXXXXXXXOOOOXOOXOXOOOOOOOOOOOOOOOOOOOOOOXXXXXXXXXOOOOOOOOOOOXOOOOOOOXOOOOOOOOOOOOOOOOOOOOOOOOOOOOXXX
PXXXXXXXXXXXXXXXXXXXXXXXXOOOOOOOOOOXXXXXXXXXXOOOOOOOOOOOOXXXXXXXXOOOOOOOOOOXXXXXXXXXXXXXXXXXXXXXXXXXXXXXXXXXXOOOOOOOOXX
PXXXXXXXXXXXXXXXXXXXXXXOOOOOOOOOOXXXXXXXXXXOOOOOOOOOOOOOXXXXXXXOOOOOOOOOOXXXOOOOOOOOOOOOOOXXXXXXXXXXXXXXXXXXOOOOOOOOOXX
PXXXXXXXXXXXXXXXXXXXXOOOOOOOOOOXXXXXXXXXXOOOOOOOOOOOOOXXXXXXXXOOOOOOOOOXXXXOOOOOOOOOOOOOOOOOXXXXXXXXXXXXXXOOOOOOOOOOXXX
PXXXXXXXXXXXXXXXXXXOOOOOOOOOOXXXXXXXXXXOOOOOOOOOOOOOXXXXXXXXXOOOOOOOOXXXXXOOOOOOOOOOOOOOOOOOOOXXXXXXXXXXOOOOOOOOOOXXXXX
PXXXXXXXXXXXXXXXXOOOOOOOOOOXXXXXXXXXXOOOOOOOOOOOOOXXXXXXXXXXXOOOOOOOOXXXXXXOOOOOOOOXXXXXXOOOOOOOOOOOOOOOOOOOOOOOXXOXXXX
XXXXXXXXXXXXXXXOOOOOXOOOOXXXXXXXXXXOOOOOOOOOOOOOXXXXXXXXXXXXXXXOOOOOOOOXXXXXOOOOOOOOXXXXOXXOOOOOOOOOOOOOOOOOOOXXXXOXXXX
XXXXXXXXXXXXXOOOOOOOXOOXXXXXXXXXXOOOOOOOOOOOOOXXXXXXXXXXXXXXXXXXXOOOOOOOOXXXXOOOOOOOOXXOXXXXXOOOOOOOOOOOOOOOXXXXXOXXXXX
XXXXXXXXXXXXXOOOOOOOXOOXXXXXXXXOOOOOOOOOOOOOXOXXXXXXXXXXXXXXXXXXXOOOOOOOOXXXXXOOOOOOXOOXXXXXXXXOOOOOOOOOOOXXXXXXXOXXXXX
XXXXXXXXXXXXXOOOXOOOOOOXXXXXXOOOOOOOOOOOOOXXXXOXXXXXXXXXXXXXXXXOOOOOOOOOXXXXOOOOOOOOXXXXXXXXXXXXXXXXXXXXXXXXXXXXXXOXXXX
XXXXXXXXXXXXXOOOXOOOXOOXXXXOOOOOOOOOOOOOXXXXXXXOXXXXXXXXXXXXXOOOOOOOOOXXXXOOOOOOOOOOXXXXXXOOOOOOOOOOOOOOOOOOOOOOXXOXXXX
XXXXXXXXXXXXXOOOXOOOOOOXXOOOOOOOOOOOOOXXXXXXXXXXOXXXXXXXXXXOOOOOOOOOXXXXOOOOXXXXOOXXXXXXXOOOOXOOXOOOOOOOOOOOOOOOOXXOXXX
XXXXXXXXXXXXXXOOOOOOOOXXOOOOOOOOOOOOXXXXXXXXXXXXXOXXXXXXXOOOOOOOOOXXXXOOOOOOOOOOOOXXXXXXOOOOOOXOOOOOOOOOOOXOOOOOOOXXOXX
XXXXXXXXXXXXXOOOOOXOOOXXXOOOOOOOOOOXXXXXXXXXXXXXXXOXXXXOOOOOOOOOXXXXOOOOOOOOOOOOOXXXXXXOOOOOOOXXXXXXXXXXXOOXOOOOOOXXOXX
XXXXXXXXXXXXXOOOOOXOOOOXXXOOOOOOOOOOXXXXXXXXXXXXXXXOXOOOOOOOOOXXXXXXXXXXXOOOOOOOXXXXXXOOOOOOOXXXXXXXXXXOOOOOOOOOOXXOXXX
XXXXXXXXXXXXXOOOOOOOOOOXXXXOOOOOOOOOOXXXXXXXXXXXXXXOOXOOOOOOXXXXXOOOOOOOOOOOOOOXXXXXXOOOOOOOXXXXXXXXXOOOOOOOOOXXXXXOXXX
XXXXXXXXXXXXXOOOOOOOOOOXXXXXOOOOOOOOOOOOOOOOOOOOOOOXOXOOOOOXXXXXOOOOOOOOOOOXXXXXXXXXOOOOOOOXXXXXXXXOOOOOOOOOXXXOOXXXOXX
XXXXXXXXXXXXXOOOOOOOOOOXXXXXXXOOOOOOOOOOOOOOOOOOOOXOOOOOOOXXXXXOOOOOOOOOOOOOOXXXXXXOOOOOOOXXXXXXXOOOOOOOOOOXXOOXOOXXOXX
XXXXXXXXXXXXXSOSOSOSOSOXXXXXXXXXOOOOOOOOOOXXXXXXOOOOOOOOOXXXXXXXXOOXXXXXXOOOXXXXXXOOOOOOOXXXXXXOOOOOOOOOOXXXXXXXXOXOXXX
XXXXXXXXXXXXXOSOSOSOSOSXXXOOOOOXXXOOOOOOOOOOOOOOOOOOXOOOXXXXXOOOOOOOOOOOOOOXXXXXXOOOOOOOXXXXXOOOOOOOOOOXXXOOOOOOXXOOXXX
XXXXXXXXXXXXXFFFFFFFFFFXXXXXOXXXXXXXXOOOOOXOOOOOOOOOOOOXXXXXOOOXXXXOOXXXOOXXXXXXOOOOOOOXXXXOOOOOOOOOOXXXOOXOOOOOOXXXOXX
XXXXXXXXXXXXOOOOOOOOOOXXXXXXOOXXXXXXXXXOOOXOOOOOOOOOOXXXXXXOOOOOOOOOOOOXXXXXXXXOOOOOOOXXXOOOOOOOOOOXXXOOOOOXOOOOOXXXOXX
XXXXXXXXXXOOOOOOOOOXXXXXXXXXOXXXXXXXXXXXXXXXXXXXXXXXXXXXXXOOXXOOOOXXXOOOXXXXXXOOOOOOOXXOOOOOOOOOOXXXOOOOOOOOXOOOOOXOXXX
XXXXXXXOOOOOOOOOXXXXXXXXXXXXOXXXXXXXXXXXXXXXXXXXXXXXXXXXXOOOOOXXXOOOOOOXXXXXXOOOOOOOXXOOOOOOOOOXXXXOOOOOOOOOOOOOOOXOXXX
XXXXOOOOOOOOXXXXXXXXXXXXXXXXXXXXXXXXXXXXXXXXXXXXXXXXXXXXOOOOOXXXOOOOOOXXXXXXOOOOOOOXXXXOOOOOXOOOOOOOOOOOOXXXOOXOOOXXOXX
XXXOOOOXOOXXXXXXXXOOOOOOOOOOOOOOOOOOOOOOOOOOOOOOOOOOOOOOOOOOXXXOOOOOOXXXXXXOOOOOOOXXXXXXOOOOOXOOOXOOOOOXXXXOOOXOOOXXOXX
XXXOOOXOOXXXXXXXXOOOOOOOOOOOOOOOOOOOOOOOOOOOOOOOOOOOOOOOOOOOOOOOOOOOXXXXXXOOOOOOOXXXXXXXXOOOOOXOXOOOOXXXOOOOOOXOOXXOXXX
XXXOOOXOOXXXXXXXOOOOOOOOOOOOOOOOOOOOOOOOOOOOOOOOOOOOOOOOOOOOOOOOOOOXXXXXXOOOOOOOXXXXXXXXXXOOOOOOOOOXXXOOOOOOOOXXOXXOXXX
XXXOOOXOOXXXXXXOOOOOOOOXXXXXXXXXXXXXXXXXXXXXXXXXXXXXXXXXXXXXXXXXXXXXXXXXOOOOOOOXXXXXXXXXXXXOOOOOOXXXOOOOOOOOOXXOXXXXOXX
XXXOOXOOOXXXXXOOOOOOOOXXXXXXXXXXXXXXXXXXXXXXXXXXXXXXXXXXXXXXXXXXXXXXXXXOOOOOOOXXXXXXXXXXXXXXXXXXXXOOOOOOOOOOXXOXXXXXOXX
XXXOOXOOOXXXXXXOOOOOOOOXXXXXXXXXXXXXXXXXXXXXXXXXXXXXXXXXXXXXXXXXXXXXXXOOOXXOXXXXXXXXXXXXXXXXXXXXOOOOOOOOOOXXXOXXOOXOXXX
XXXOOOOOOXXXXXXXOOOOOOOOOOOOOOOOOOOOOOOOOOXOOOOOOOOOOOOOOXOOOOOOOOOOOOOOOOOOXXXXXXXXXXXXXXXXXXOOOOOOOOOOXXXXOXXOXOXOXXX
XXXOOOOOOXXXXXXXXOOOXXXXXXXXOOOOOOOOOOOOOXOOOOOOOOOOOOOOOOXOOOOOOOOOOOOOOOOXXXXXXXXXXXXXXXXXOOOOOOOOOOXXXXXOXXXOXOXXOXX
XXXOOOOOOXXXXXXXXXOOOOOOOOOOOOOOOOOOOOOOXOOOOOOOOOOOOOOOOOOXOOOOOOOOOOOOOOXXXXXXXXXXXXXXXXOOOOOOOOOOXXXXXXXOXXOXOXXXOXX
XXXOOOOOOXXXXXXXXXXOOOOOOOOOOOOOOOOOOOOXOOOOOOOOOOOOOOOOOOOOXOOOOOOOOOOOOXXXXXXXXXXXXXXXXOOOOOOOOOOXXXXXXXOXXXOXOXXOXXX
XXXOOOOOOXXXXXXXXXXXXXXXXXXXXXXXXXXXXXXXXXXXXXXXXXXXXXXXXXXXXXXXXXXXXXXXXXXXXXXXXXXXXXXXXXOOOOOOOXOOXXXXXXOXXOXXXOXOXXX
XXXOOOOOOXXXXXXXXXXXXXXXXXXXXXXXXXXXXXXXXXXXXXXXXXXXXXXXXXXXXXXXXXXXXXXXXXXXXXXXXXXXXXXXXXXXOOOOOXOOOOXXXXXOXOXXXOXOXXX
XXXOOOOOOOXXXXXXXXXXXXXXXXXXXXXXXXXXXXXXXXXXXXXXXXXXXXXXXXXXXXXXXXXXXXXXXXXXXXXXXXXXXXXXXXXXXXXOOOOOOOOOXXXOXXOXOXXXOXX
XXXOOOOOOOOXXXXXOOOOOOOOOOOOOOOOOOOOOOOOOOOXXXXXXXXXXXXOOOOOOOOOOOOOOOOOOOOOOOOXXXOOOOOOOOOOOOXXOOXXXOOOOXXXOXOXOXXOXXX
XXXXXXXXOOOOOOOOOOOOOOOOOOOOOOOOOXXXXXOOOOOOOOOOOOOOOOOOOOOOOOOOOOOOOOXXXXXOOOOOOOOOOOOOOOOOOOOOOOOOOOOOXXXXOOXXXOXOXXX
XXXXXXOOOOOOOOOOOOXXXXXXXOOOOOOOOOOOOOOOOOOOOOOOOOOOOOOOXXXXXXOOOOOOOOOOOOOOOOOOOOOOXXXXXXXXXOOXXOOOOOXXXXXXXXXXXOOXXXX
XXXXXXXXXXXXXXXXXXXXXXXXXXXXXXXXXXXXXXXXXXXXXXXXXXXXXXXXXXXXXXXXXXXXXXXXXXXXXXXXXXXXXXXXXXXXXXXXXXXXXXXXXXXXXXXXXXXXXXX
XXXXXXXXXXXXXXXXXXXXXXXXXXXXXXXXXXXXXXXXXXXXXXXXXXXXXXXXXXXXXXXXXXXXXXXXXXXXXXXXXXXXXXXXXXXXXXXXXXXXXXXXXXXXXXXXXXXXXXX
